Lemma	Gloss	Part	Chapter
ἀγάπη	love	noun	2
ἀλήθεια	truth	noun	2
δικαιοσύνη	righteousness	noun	2
εἰρήνη	peace	noun	2
καρδία	heart	noun	2
κεφαλή	head	noun	2
σοφία	wisdom	noun	2
φωνή	voice; sound	noun	2
χαρά	joy	noun	2
ψυχή	soul; life	noun	2
ἄνθρωπος	man; mankind	noun	3
δαιμόνιον	demon	noun	3
δοῦλος	slave	noun	3
εὐαγγέλιον	good news; gospel	noun	3
θεός	God	noun	3
κύριος	lord; Lord	noun	3
λόγος	word; reason; account	noun	3
παιδίον	little child; dear child	noun	3
τέκνον	child	noun	3
υἱός	son	noun	3
ἀκούω	I hear; I listen to	verb	4
βάλλω	I throw; I put	verb	4
βλέπω	I see	verb	4
γίνομαι	I become; it happens (3rd person sing.)	verb	4
δέχομαι	I receive	verb	4
ἔρχομαι	I come, go	verb	4
ἐσθίω	I eat	verb	4
ἔχω	I have, possess; I hold	verb	4
λύω	I loose, loosen, untie; I destroy	verb	4
πορεύομαι	I go, travel	verb	4
ἄγω	I lead, drive	verb	5
βαπτίζω	I baptize	verb	5
γράφω	I write	verb	5
διδάσκω	I teach	verb	5
θεραπεύω	I heal	verb	5
λέγω	I say, speak	verb	5
λογίζομαι	I consider, reckon	verb	5
μένω	I remain	verb	5
πιστεύω	I believe	verb	5
σῴζω	I save; I heal	verb	5
ἀγαπάω	I love	verb	6
αἰτέω	I ask for, request	verb	6
γεννάω	I sire, beget; I give birth to	verb	6
ἐρωτάω	I ask, question	verb	6
ζητέω	I seek; I try to	verb	6
καλέω	I call; I name	verb	6
λαλέω	I talk, speak	verb	6
πληρόω	I fulfill, complete; I fill	verb	6
ποιέω	I do, practice; I make	verb	6
φοβέομαι	I fear, am afraid	verb	6
οὐ	no; not	adverb	6
οὐχί	no!	adverb	6
ἀκολουθέω	I follow (direct object in dative case)	verb	7
ἅπτομαι	I touch	verb	7
ἄρχομαι	I begin	verb	7
διώκω	I pursue; I persecute	verb	7
δοξάζω	I glorify	verb	7
εὐαγγελίζω	I preach the gospel, announce good news	verb	7
κηρύσσω	I announce, proclaim	verb	7
κόπτω	I cut	verb	7
πέμπω	I send	verb	7
πράσσω	I do	verb	7
ἀνοίγω	I open	verb	8
ἀποκαλύπτω	I reveal, uncover	verb	8
ἀπολύω	I release, send away; I destroy	verb	8
ἀσπάζομαι	I greet	verb	8
εἰσέρχομαι	I go into, enter	verb	8
ἐκβάλλω	I throw out; I send away; I divorce	verb	8
περιπατέω	I walk	verb	8
περισσεύω	I increase; I provide in abundance	verb	8
συνάγω	I gather together, assemble	verb	8
ὑποτάσσω	I subject	verb	8
ἁμαρτάνω	I sin; I err	verb	9
ἀναβαίνω	I go up; I ascend	verb	9
ἀποθνῄσκω	I die	verb	9
γινώσκω	I know; I understand, discern	verb	9
ἐξέρχομαι	I go out, depart	verb	9
εὑρίσκω	I find; I obtain	verb	9
καταβαίνω	I go down, descend	verb	9
λαμβάνω	I take, receive	verb	9
πίνω	I drink	verb	9
πίπτω	I fall	verb	9
εἰμί	I am; I exist	verb	10
ἀγαθός	good	adjective	10
ἀγαπητός	beloved, dear	adjective	10
ἅγιος	holy; saints (pl. substantive)	adjective	10
δίκαιος	righteous, just	adjective	10
ἕτερος	other, another, different	adjective	10
κακός	bad, evil	adjective	10
καλός	good, excellent; beautiful, handsome	adjective	10
νεκρός	dead	adjective	10
πιστός	faithful, believing	adjective	10
πονηρός	evil, wicked	adjective	10
αἰών	age; the world	noun	11
αἰώνιος	eternal	adjective	11
ἀνήρ	man; husband	noun	11
γυνή	woman; wife	noun	11
ὄνομα	name	noun	11
πνεῦμα	Spirit; spirit; breath; wind	noun	11
πούς	foot	noun	11
σάρξ	flesh	noun	11
σῶμα	body	noun	11
φῶς	light	noun	11
χείρ	hand	noun	11
ἀρχιερεύς	high priest	noun	12
βασιλεύς	king	noun	12
γραμματεύς	scribe	noun	12
δύναμις	power	noun	12
ἔθνος	nation; Gentiles (pl.)	noun	12
μήτηρ	mother	noun	12
ὄρος	mountain	noun	12
πᾶς	all, every; whole	adjective	12
πατήρ	father	noun	12
πίστις	faith, trust	noun	12
πόλις	city	noun	12
ἀπό	+gen., from	preposition	13
διά	+gen., through; +acc., because of	preposition	13
εἰς	+acc., unto, into, to, in	preposition	13
ἐκ	+gen., out of, from	preposition	13
ἐν	+dat., in, on, among, by (means of)	preposition	13
ἐπί	+gen., on, upon; +dat., upon, on the basis of; +acc., against, upon	preposition	13
κατά	+gen., down from, against; +acc., according to	preposition	13
μετά	+gen., with; +acc., after	preposition	13
παρά	+gen., from, with; +dat., with, beside; +acc., beside	preposition	13
περί	+gen., concerning, about; +acc., around	preposition	13
πρός	+acc., to, toward, in the presence of	preposition	13
σύν	+dat., with, along with	preposition	13
ὑπέρ	+gen., on behalf of, for the sake of; +acc., above	preposition	13
ὑπό	+gen., by; +acc., under	preposition	13
ἀπέρχομαι	I go away; leave	verb	14
ἐγγίζω	I draw near, approach	verb	14
μαρτυρέω	I testify, bear witness	verb	14
ὁράω	I see	verb	14
πείθω	I persuade	verb	14
προσέρχομαι	I come to, approach	verb	14
τηρέω	I keep; I guard	verb	14
βασιλεία	kingdom	noun	14
ἔργον	work; deed	noun	14
καί	and, also, even	conjunction	14
ἐπερωτάω	I ask; I question	verb	15
ζάω	I live, am alive	verb	15
θεωρέω	I look at, gaze	verb	15
παρακαλέω	I exhort; I comfort, console	verb	15
προσεύχομαι	I pray	verb	15
προσκυνέω	I worship, bow before	verb	15
ὑπάγω	I pass by, depart	verb	15
ἤδη	already	adverb	15
λαός	people, nation	noun	15
ὄχλος	crowd	noun	15
αὐτός	he, she, it; himself, herself, itself; same	pronoun	16
ἑαυτοῦ	himself, herself, itself	pronoun	16
ἐγώ	I	pronoun	16
ἐμαυτοῦ	myself (genitive form; there is no nominative)	pronoun	16
ἐμός	my (possessive pronoun adjective, often emphatic)	adjective	16
ἴδιος	one's own; peculiar	adjective	16
οἰκία	household, family; house	noun	16
οἶκος	house; household	noun	16
σεαυτοῦ	yourself (genitive form; there is no nominative)	pronoun	16
σύ	you	pronoun	16
ὧδε	here	adverb	16
δέ	and; but, however (postpositive)	conjunction	17
εἰ	if; since, whether	conjunction	17
ἐκεῖνος	that	pronoun	17
ἐκκλησία	church; assembly	noun	17
νόμος	law, principle	noun	17
ὅτι	that; because	conjunction	17
οὗτος	this; he, she, it	pronoun	17
σάββατον	Sabbath	noun	17
τίς	who? what?; τί, why?	pronoun	17
τις	someone, something; anyone, anything; certain	pronoun	17
αἴρω	I raise, lift; I carry, remove	verb	18
ἀπαγγέλλω	I announce, report	verb	18
ἀποκρίνομαι	I answer (direct object in dative case)	verb	18
ἀποκτείνω	I kill	verb	18
ἀποστέλλω	I send out	verb	18
ἐγείρω	I raise	verb	18
κρίνω	I judge; I condemn	verb	18
σπείρω	I plant	verb	18
ἄγγελος	angel, messenger	noun	18
ἀπόστολος	apostle; emissary	noun	18
κράζω	I shout, cry out	verb	19
φέρω	I bear, carry	verb	19
ἀρχή	beginning	noun	19
γῆ	earth; land	noun	19
ζωή	life	noun	19
ἡμέρα	day	noun	19
θάνατος	death	noun	19
κόσμος	world; adornment	noun	19
νύξ	night	noun	19
οὐρανός	heaven	noun	19
στόμα	mouth	noun	19
ὑπάρχω	I exist; I belong to	verb	20
χαίρω	I rejoice	verb	20
ἄρτος	bread; loaf (of bread)	noun	20
γλῶσσα	tongue; speech, language	noun	20
δόξα	glory, fame	noun	20
θάλασσα	sea; lake	noun	20
καρπός	fruit	noun	20
μή	no, not (used with non-indicative moods including participles)	adverb	20
ὀφθαλμός	eye	noun	20
πρόσωπον	face; appearance; person	noun	20
τυφλός	blind (often used as a substantive: ὁ τυφλός "the blind man")	adjective	20
γραφή	Scripture; writing	noun	21
ἐντολή	commandment	noun	21
καιρός	season; a time, age	noun	21
παραβολή	parable	noun	21
ῥῆμα	word, speech	noun	21
χρόνος	time	noun	21
ὥρα	hour	noun	21
ἀλλά	but, however, in contrast (ἀλλ' when followed by a vowel)	conjunction	21
γάρ	for, because (postpositive)	conjunction	21
εὐθύς	immediately	conjunction	21
οὖν	therefore, then (continuation of an argument) (postpositive)	conjunction	21
ἀμήν	truly	interjection	22
ἄν	(not usually translated; indefinite particle) "ever"	conjunction	22
ἐάν	if; if ever (combination of εἰ and ἀν)	conjunction	22
ἐὰν μή	unless; if not	conjunction	22
ἕως	until; while (adverb); as prep. +gen to, until	preposition	22
ἵνα	in order that; that	conjunction	22
ὅπου	where (ὅπου ἄν or ὅπου ἐάν, wherever, whenever)	adverb	22
ὅπως	in order that; that	conjunction	22
ὅταν	when; whenever (from ὅτε + ἀν)	conjunction	22
ὅτε	when	conjunction	22
οὕτως	so, thus, in this way (from οὗτος + ὡς)	adverb	22
ὡς	as; like (with numbers: "about" "approximately")	conjunction	22
οἶδα	I know	verb	23
ἀδελφός	brother	noun	23
ἀλλήλων	(of) one another (reciprocal pronoun; the genitive plural is the lexical form)	pronoun	23
ἄλλος	other, another	adjective	23
ἐξουσία	authority; power	noun	23
ἰδού	look!, behold!	interjection	23
λίθος	stone	noun	23
λοιπός	remaining, rest	adjective	23
ὅς	who, which	pronoun	23
ὅσος	as much as, as many as; as great as; all that	pronoun	23
τοιοῦτος	of such a kind, such as this, such	pronoun	23
διδάσκαλος	teacher	noun	24
ἔρημος	desert, wilderness	noun	24
θρόνος	throne	noun	24
Ἰησοῦς	Jesus	noun	24
Ἰωάννης	John	noun	24
μαθητής	disciple	noun	24
ὁδός	road, way	noun	24
προφήτης	prophet	noun	24
σημεῖον	sign; miracle	noun	24
συναγωγή	synagogue	noun	24
Χριστός	Christ, Messiah; anointed one	noun	24
ἕκαστος	each	adjective	25
ἐνώπιον	in the presence of, before (prep. +gen)	preposition	25
ἐπαγγελία	promise	noun	25
ἤ	or; than (ἤ...ἤ, either... or)	conjunction	25
κἀγώ	and I; even I (= καί + ἐγω–used for emphasis or contrast)	pronoun	25
μέν	and (μέν...δέ, on the one hand... on the other hand)	particle	25
μηδέ	nor, and not (μηδέ...μηδέ, neither...nor) (with non-indicative mood verbs)	particle	25
οὐδέ	nor, and not (οὐδέ...οὐδέ, neither...nor)	adverb	25
πῶς	how; how?	adverb	25
ὕδωρ	water	noun	25
χάρις	grace, favor	noun	25
δεῖ	it is necessary, one most	verb	26
δοκέω	I seem to; I suppose, think	verb	26
δύναμαι	I am able to, I can	verb	26
θέλω	I want to, wish	verb	26
μέλλω	I am about to; it is destined (in third person)	verb	26
ἁμαρτία	sin	noun	26
θέλημα	will, wish	noun	26
ἱμάτιον	clothing; coat	noun	26
πλοῖον	boat	noun	26
πρό	+gen., before, beforehand; in front of	preposition	26
ὥστε	so that, with the result that; so as	conjunction	26
ἀνίστημι	I stand up, arise	verb	27
δίδωμι	I give	verb	27
ἵστημι	I stand; 1Aor "I stood (something) up"; 2Aor "I stood up" (intrans)	verb	27
παραδίδωμι	I hand over, betray	verb	27
τίθημι	I place, put; appoint	verb	27
αἷμα	blood	noun	27
ἱερόν	temple	noun	27
πῦρ	fire	noun	27
τόπος	place	noun	27
τότε	then; at that time	adverb	27
ἀπόλλυμι	I destroy; (middle: I perish)	verb	28
ἀφίημι	I forgive; I allow; I dismiss	verb	28
κάθημαι	I sit; I stay	verb	28
φημί	I say	verb	28
δεξιός	right; ἐν δεξιᾷ (χειρί) on the right (hand)	adjective	28
διό	wherefore, therefore	conjunction	28
εἴτε	if, whether; εἴτε...εἴτε, whether...or,if...if (= εἰ + τέ)	conjunction	28
καθώς	just as, as	conjunction	28
μέσος	middle; ἐν μέσῳ "in the midst"	adjective	28
νῦν	now, at present; νυνί, at this moment (emphatic form)	adverb	28
οὔτε	not, nor; οὔτε...οὔτε, neither...nor (= οὐ + τέ)	particle	28
τέ	and, but, also (postpositive) (synonym of δέ but more "literary")	conjunction	28
ἀληθής	true; genuine	adjective	29
ἐκεῖ	there, in that place	adverb	29
ἔξω	out(side) (adv.); +gen., out of	adverb	29
ἔτι	still, yet	adverb	29
μακάριος	blessed	adjective	29
μᾶλλον	more; rather; πολλῷ μάλλον, all the more, much more	adverb	29
μέγας	great; large	adjective	29
μείζων	greater; larger (comparative of μέγας)	adjective	29
πάλιν	again	adverb	29
πλείων	more; greater; πλεῖον, more, most (adv.) (comparative of πολύς)	adjective	29
πολύς	much, many; often (adv.)	adjective	29
πρεσβύτερος	older, elder	adjective	29
δύο	two (not declined)	adjective	30
δώδεκα	twelve (not declined)	adjective	30
εἷς	one	adjective	30
μία	one	adjective	30
ἕν	one	adjective	30
ἐλπίς	hope	noun	30
ἑπτά	seven (not declined)	adjective	30
ἔσχατος	last, final	adjective	30
μηδείς	no one (= μή + εἷς – used with non-indicative verbs)	adjective	30
μόνος	only, the single	adjective	30
ὅλος	whole, entire	adjective	30
οὐδείς	no one (= οὐ + εἷς – used with indicative verbs)	adjective	30
πρῶτος	first (an ordinal number)	adverb	30
τρεῖς	three	adjective	30
ἁμαρτωλός	sinful	adjective	31
ἀποδίδωμι	I am repaying, giving away	verb	31
ἄρα	consequently, so then	conjunction	31
ἄχρι	until (conj, prep +gen.)	preposition	31
ἔμπροσθεν	+gen., before, in the presence of	preposition	31
ἔτος	year	noun	31
ἡμέτερος	our	adjective	31
θεάομαι	I am beholding, viewing	verb	31
θηρίον	animal, wild beast	noun	31
καθίζω	I am sitting (middle); I am causing to sit	verb	31
κοινωνία	fellowship	noun	31
κρατέω	I am seizing, grasping	verb	31
κρίσις	judgment	noun	31
μικρός	small, little	adjective	31
οὐαί	woe, alas	interjection	31
οὐκέτι	no longer, no more	adverb	31
μηκέτι	no longer, no more	adverb	31
παραλαμβάνω	I am taking; I am taking along	verb	31
ποῦ	where, where?	adverb	31
προσφέρω	I am offering, bringing to	verb	31
σταυρόω	I am crucifying	noun	31
φανερόω	I am revealing; I am appearing (pass.)	verb	31
φόβος	fear	noun	31
φυλακή	guard, prison	noun	31
χρεία	need, necessity	noun	31
ψηλαφάω	I am touching, handling	verb	31
ἀγγελία	message	noun	32
ἀδικία	unrighteousness	noun	32
ἀναγγέλλω	I am announcing, reporting	verb	32
ἀνάστασις	resurrection	noun	32
γενεά	generation; family	noun	32
δεύτερος	second	adjective	32
δέω	I am binding	verb	32
διέρχομαι	I am going through; I am spreading	verb	32
ἐπιγινώσκω	I understand, know well	verb	32
εὐλογέω	I am blessing	verb	32
θαυμάζω	I am amazed; I am surprised	verb	32
θλῖψις	tribulation, affliction	noun	32
καθαρίζω	I am cleansing	verb	32
κατοικέω	I am living, dwelling	verb	32
ναός	sanctuary, temple	noun	32
ὅμοιος	similar, like	adjective	32
ὁμολογέω	I am confessing, professing	verb	32
πλανάω	I am deceiving	verb	32
σκοτία	darkness	noun	32
σκότος	darkness	noun	32
σπέρμα	seed	noun	32
σωτηρία	salvation; health	noun	32
φωνέω	I am calling	verb	32
ψεύδομαι	I am lying	verb	32
ψεύστης	liar	noun	32
ἀληθῶς	truly	adverb	33
ἄξιος	worthy	adjective	33
ἐργάζομαι	I am working	verb	33
ἑτοιμάζω	I am preparing	verb	33
ἱλασμός	propitiation	noun	33
καινός	new, different	adjective	33
κλαίω	I am weeping	verb	33
μέρος	part, portion	noun	33
μισέω	I hate	verb	33
μνημεῖον	monument, grave	noun	33
οἰκοδομέω	I am building; I am edifying	verb	33
ὀλίγος	little, small, few	adjective	33
ὀφείλω	I ought; I owe	verb	33
πάντοτε	always	adverb	33
παράκλητος	advocate; helper	noun	33
παρίστημι	I am presenting, approaching	verb	33
πάσχω	I am suffering, experiencing	verb	33
σήμερον	today	adverb	33
τεκνίον	dear child, little child	noun	33
τελειόω	I am completing, fulfilling	verb	33
τέλος	end, goal; tax	noun	33
τέσσαρες	four	adjective	33
τιμή	honor; value	noun	33
χωρίς	+gen., apart from, besides	preposition	33
ἀληθινός	true, genuine	adjective	34
ἄρτι	now, just	adverb	34
ἄρχων	ruler	noun	34
βούλομαι	I want, wish	verb	34
διάβολος	Devil	noun	34
διακονέω	I am serving	verb	34
δικαιόω	I am justifying; I am vindicating	verb	34
ἐκεῖθεν	from there, thence	adverb	34
ἐπιθυμία	lust; longing	noun	34
ἐπιτίθημι	I am putting on; I am adding	verb	34
εὐχαριστέω	I am giving thanks	verb	34
θύρα	door	noun	34
ἱκανός	enough; many	adjective	34
ἰσχυρός	strong	adjective	34
καλῶς	well	adverb	34
καυχάομαι	I am boasting, glorifying in	verb	34
νεανίσκος	young man	noun	34
παλαιός	old, ancient	adjective	34
παράγω	I am introducing; I am passing away (passive)	verb	34
πειράζω	I am tempting, testing, trying	verb	34
πέντε	five	adjective	34
πρόβατον	sheep	noun	34
σκάνδαλον	offense, stumbling block	noun	34
τυφλόω	I am blinding (someone); I am blind (passive)	verb	34
φαίνω	I am shining, appearing	verb	34
ἀγρός	field; farms	noun	35
ἀλαζονεία	arrogance, pride	noun	35
ἀντίχριστος	Antichrist	noun	35
ἅπας	all, every	adjective	35
ἀρνέομαι	I am denying	verb	35
βιβλίον	book, scroll	noun	35
βίος	life; belongings	noun	35
βλασφημέω	I am blaspheming, reviling	verb	35
διακονία	service, ministry	noun	35
ἐπαγγέλλομαι	I am promising	verb	35
ἐπιστρέφω	I am returning, turning	verb	35
εὐθέως	immediately	adverb	35
μαρτυρία	testimony, witness	noun	35
μάρτυς	witness	noun	35
ὅθεν	from where, whence	conjunction	35
ὀπίσω	behind, after (adverb or prep +gen.)	preposition	35
ὀργή	anger, wrath	noun	35
οὖς	ear	noun	35
παραγίνομαι	I am arriving, appearing	verb	35
περιτομή	circumcision	noun	35
προσευχή	prayer	noun	35
ὑποστρέφω	I am turning back, returning	verb	35
χρῖσμα	anointing	noun	35
ψεῦδος	lie	noun	35
ὥσπερ	as, just as	conjunction	35
ἁγνίζω	I am purifying	verb	36
ἁγνός	pure	noun	36
αἰσχύνομαι	I am ashamed; I put to shame	verb	36
ἀκάθαρτος	unclean	adjective	36
ἀναγινώσκω	I am reading	verb	36
ἀσθενέω	I am weak, sick	verb	36
δείκνυμι	I am showing, proving	verb	36
διαθήκη	covenant; last will	noun	36
δυνατός	able; powerful	adjective	36
ἐκπορεύομαι	I am going out	verb	36
ἐχθρός	hostile; enemy	adjective	36
ἥλιος	sun	noun	36
μέλος	member, limb	noun	36
μετανοέω	I am repenting	verb	36
μήτε	neither...nor, and not	conjunction	36
ναί	yes	particle	36
οἶνος	wine	noun	36
οὔπω	not yet	adverb	36
παραγγέλλω	I am ordering, instructing	verb	36
παρουσία	arrival, coming	noun	36
παρρησία	boldness, confidence	noun	36
ποῖος	what kind? what?	pronoun	36
ποταπός	what kind, what manner	adjective	36
πτωχός	poor	adjective	36
ὑπομονή	endurance, perseverance; patience	noun	36
ἀγοράζω	I am buying	verb	37
ἄνεμος	wind	noun	37
ἀνομία	lawlessness	noun	37
ἀρνίον	lamb, sheep	noun	37
γνῶσις	knowledge	noun	37
διάκονος	servant; deacon	noun	37
διδαχή	teaching	noun	37
ἐγγύς	near	adverb	37
ἐλεέω	I have mercy on	verb	37
ἐλπίζω	I hope	verb	37
ἔξεστι	it is lawful, allowed	verb	37
ἐπικαλέω	I am calling; I am appealing	verb	37
ἐπιτιμάω	I am rebuking, warning	verb	37
ἴδε	look, behold	verb	37
ἱερεύς	priest	noun	37
μάχαιρα	knife; sword	noun	37
ὁμοίως	likewise, similarly	adverb	37
πλῆθος	crowd; quantity	noun	37
πλήν	only, however	conjunction	37
ποτήριον	cup	noun	37
συνείδησις	conscience	noun	37
συνέρχομαι	I am coming together	verb	37
φανερός	clear, evident	adjective	37
φυλάσσω	I am guarding	verb	37
φυλή	tribe, people	noun	37
ἁγιάζω	I am sanctifying, consecrating	verb	38
ἀδικέω	I am doing wrong, harming	verb	38
ἀνθρωποκτόνος	murderer	noun	38
γαμέω	I am marrying	verb	38
ἡγέομαι	I am leading, ruling; I am thinking	verb	38
θυγάτηρ	daughter	noun	38
θυσία	sacrifice, offering	noun	38
ἰσχύω	I am able; I am strong	verb	38
κλείω	I am shutting	verb	38
μεταβαίνω	I am passing over, transferring	verb	38
μισθός	wages, reward	noun	38
μυστήριον	mystery	noun	38
νικάω	I am conquering	verb	38
παράκλησις	comfort, consolation	noun	38
παρέρχομαι	I am passing by; I am neglecting	verb	38
πάσχα	Passover	noun	38
πόθεν	from where?	adverb	38
ποτέ	once, formerly, ever	adverb	38
προσκαλέω	I am summoning, calling (middle only)	verb	38
σκανδαλίζω	I am making (someone) stumble	verb	38
σπλάγχνον	compassion, feelings	noun	38
σφάζω	I am slaying	verb	38
φεύγω	I am fleeing, escaping	verb	38
φίλος	friend (masc. or fem.); friendly (as adj.)	adjective	38
χάριν	+gen., because of, for the sake of	preposition	38
ἀδελφή	sister	noun	39
ἀρεστός	pleasing	adjective	39
ἀσθενής	weak, helpless	adjective	39
βαστάζω	I am bearing, carrying; I am enduring	verb	39
δοκιμάζω	I am testing, proving; I am tempting	verb	39
ἐκχέω	I am pouring out, shedding	verb	39
ἔλεος	mercy, compassion	noun	39
ἐνδύω	I am dressing; I am putting on (middle)	verb	39
ἕνεκα	+gen., because of, on account of	preposition	39
ἐπεί	since, for	conjunction	39
ἥκω	I have come; I am present	verb	39
καθαρός	clean	adjective	39
καταγινώσκω	I am condemning, blaming	verb	39
καταργέω	I am abolishing, nullifying	verb	39
κρίμα	judgement	noun	39
κώμη	village	noun	39
πλάνη	deception; error	noun	39
πλούσιος	rich, wealthy	adjective	39
πόσος	how many (?); how great (?) (sometimes interrogative)	pronoun	39
προφητεύω	I am prophesying	verb	39
σός	your (pronominal adjective like ἐμός)	adjective	39
σταυρός	cross	noun	39
τελέω	I am completing, fulfilling	verb	39
ψευδοπροφήτης	false prophet	noun	39
χώρα	field, rural area, countryside	noun	39
ἀναβλέπω	I am receiving sight; I am looking up	verb	40
γέ	indeed	particle	40
γνωρίζω	I am making known	verb	40
δέκα	ten	adjective	40
δένδρον	tree	noun	40
δουλεύω	I am enslaved; I am serving	verb	40
ἑορτή	feast	noun	40
ἰάομαι	I am healing	verb	40
κελεύω	I am commanding	verb	40
κόλασις	penalty, punishment	noun	40
λευκός	white	adjective	40
λυπέω	I am grieving, hurting	verb	40
μανθάνω	I am learning	verb	40
μήποτε	lest, otherwise; perhaps	conjunction	40
μονογενής	only-begotten, unique	adjective	40
νεφέλη	cloud	noun	40
ὀμνύω	I swear an oath	verb	40
πνευματικός	spiritual	adjective	40
πώποτε	ever, at any time	adverb	40
στρατιώτης	soldier	noun	40
συνίημι	I understand	verb	40
σωτήρ	savior, benefactor	noun	40
τέλειος	complete, perfect	adjective	40
φρονέω	I am thinking	verb	40
χήρα	widow	noun	40
ἀκοή	hearing; account	noun	41
ἀμπελών	vineyard	noun	41
ἀναιρέω	I take away, destroy; take up (middle)	verb	41
ἄπιστος	unbelieving	adjective	41
ἀσθένεια	weakness, sickness	noun	41
ἀστήρ	star	noun	41
αὐξάνω	I increase, grow	verb	41
βαρύς	heavy, burdensome	adjective	41
διότι	therefore; because	conjunction	41
εἰκών	image	noun	41
ἐλεύθερος	free	adjective	41
ἐπιστολή	letter, epistle	noun	41
ζῷον	living being, animal	noun	41
θυσιαστήριον	altar	noun	41
καταλείπω	I leave behind, abandon	verb	41
κεῖμαι	I lie down; I exist	verb	41
νίκη	victory	noun	41
νοῦς	mind; thought	noun	41
οὗ	where, to which	adverb	41
παῖς	boy or girl, child; slave	noun	41
πάρειμι	I am present	verb	41
πίμπλημι	I fill, fulfill; come to pass (passive)	verb	41
πορνεία	fornication, sexual immorality	noun	41
προσέχω	I devote myself to	verb	41
φιλέω	I love; I kiss	verb	41
αἴτημα	request	noun	42
ἀντί	instead of, on behalf of (prep. +gen.)	preposition	42
γρηγορέω	I am watching, awake	verb	42
δέομαι	I am begging, praying	verb	42
διάνοια	understanding, insight; mind	noun	42
ἀγνοέω	I am ignorant, do not know	verb	42
εἴδωλον	idol	noun	42
ἐκλέγομαι	I am choosing, electing	verb	42
ἐκλεκτός	chosen, elect	adjective	42
καθεύδω	I am sleeping	verb	42
κατεργάζομαι	I am accomplishing, producing	verb	42
κατηγορέω	I am accusing	verb	42
κοιλία	stomach; womb	noun	42
κοπιάω	I am laboring, working hard; bearing	verb	42
κωλύω	I hinder	verb	42
μετάνοια	repentance	noun	42
μιμνῄσκομαι	I remember	verb	42
νέος	new, young	adjective	42
πεινάω	I am hungry	verb	42
πέραν	other side; across (prep. +gen.)	preposition	42
περιβάλλω	I am clothing, dressing	verb	42
πληγή	blow (from hitting); plague	noun	42
πλοῦτος	wealth	noun	42
σκεῦος	vessel, jar	noun	42
χαρίζομαι	I am granting; I am forgiving	verb	42
εἶπον	I say, tell	verb	43
εἶδον	I see	verb	43
Ἰουδαῖος	Jew; Judean	noun	43
Παῦλος	Paul	noun	43
Πέτρος	Peter	noun	43
ὅστις	rel. who, which	pronoun	43
Φαρισαῖος	Pharisee	noun	43
Μωϋσῆς	Moses	noun	43
Ἰερουσαλήμ	Jerusalem	noun	43
Σίμων	Simon	noun	43
Ἀβραάμ	Abraham	noun	43
Ἰσραήλ	Israel	noun	43
Ἱεροσόλυμα	Jerusalem	noun	43
Γαλιλαία	Galilee	noun	43
Δαυίδ	David	noun	43
τρίτος	third	adjective	43
Πιλᾶτος	Pilate	noun	43
Ἰούδας	Judas; Judah	noun	43
Ἡρῴδης	Herod	noun	43
Ἰουδαία	Judea	noun	43
Ἰάκωβος	James	noun	43
Σατανᾶς	Satan	noun	43
Φίλιππος	Phillip	noun	43
Ἰωσήφ	Joseph	noun	43
Καῖσαρ	Caesar; emperor	noun	43
Ἠλίας	Elijah	noun	44
Βαρναβᾶς	Barnabas	noun	44
Μαρία	Mary	noun	44
Ἰακώβ	Jacob	noun	44
Μαριάμ	Mary	noun	44
Αἴγυπτος	Egypt	noun	44
Τιμόθεος	Timothy	noun	44
χιλιάς	thousand	adjective	44
Μακεδονία	Macedonia	noun	44
τεσσεράκοντα	forty	adjective	44
κἀκεῖνος	and + that one	pronoun	44
Ἠσαΐας	Isaiah	noun	44
συνέδριον	council; Sanhedrin	noun	44
ὑπακούω	I obey	verb	44
μνημονεύω	I remember	verb	44
ὡσεί	about, like, as	conjunction	44
εὐδοκέω	I take delight; I am well pleased	verb	44
ἐνεργέω	I work; I am at work	verb	44
τελώνης	tax collector	noun	44
διδασκαλία	instruction, teaching	noun	44
χιλίαρχος	military tribune	noun	44
καθίστημι	I appoint, put in charge	verb	44
θερίζω	I reap	verb	44
πειρασμός	temptation, test, trial	noun	44
τιμάω	I honor	verb	44
στρέφω	I turn, turn around	verb	45
ἰχθύς	fish	noun	45
ἑκατοντάρχης	centurion	noun	45
σοφός	wise	adjective	45
ὑπηρέτης	servant, officer, assistant	noun	45
ἀργύριον	silver; money	noun	45
Ἰσαάκ	Isaac	noun	45
ξύλον	tree, wood; club, cudgel	noun	45
ἀκροβυστία	uncircumcision	noun	45
αἰτία	cause, reason, charge	noun	45
νυνί	now	adverb	45
γονεύς	parent	noun	45
γένος	nation, people; class, kind	noun	45
ἐπίγνωσις	knowledge; recognition	noun	45
παρατίθημι	I set before; I place beside	verb	45
κριτής	judge	noun	45
κτίσις	creation	noun	45
διακρίνω	I waver, doubt	verb	45
μαρτύριον	testimony, witness	noun	45
παράπτωμα	sin, trespass	noun	45
βάπτισμα	baptism	noun	45
πότε	when	adverb	45
ἐπάνω	+gen., above, over, on	preposition	45
ἐπαίρω	I lift up, raise up	verb	45
ἀπέχω	I abstain; I am distant	verb	45
προφητεία	prophecy	noun	46
ἐπουράνιος	heavenly	adjective	46
δῶρον	gift, offering	noun	46
παραχρῆμα	at once, immediately	adverb	46
κληρονομέω	I inherit	verb	46
μήν 2	month	noun	46
δεσμός	bond, fetter, bonds	noun	46
δέησις	prayer, supplication	noun	46
κενός	vain, empty, empty-handed	adjective	46
μήτι	not, surely not, perhaps	particle	46
χρυσοῦς	gold, golden	adjective	46
ἀποκάλυψις	revelation	noun	46
Ἀντιόχεια	Antioch	noun	46
ἐπιβάλλω	I put on; I lay a hand on	verb	46
ἐπιτρέπω	I allow, permit	verb	46
προστίθημι	I add, put to; I proceed, go on	verb	46
ποιμήν	shepherd	noun	46
στέφανος	crown	noun	46
οἰκοδομή	edification, building	noun	46
ἀριθμός	number	noun	46
πυλών	gateway, gate	noun	46
θυμός	anger, wrath, indignation	noun	46
πόλεμος	war, battle	noun	46
ἀπώλεια	destruction, waste	noun	46
Ἀσία	Asia	noun	46
βλασφημία	blasphemy, slander	noun	47
κρύπτω	I hide, conceal	verb	47
πολλάκις	many times, often	adverb	47
ἑκατόν	hundred	adjective	47
ἐπαύριον	on the next day	adverb	47
πλησίον	subst., neighbor; +gen., near	preposition	47
ὡσαύτως	likewise, similarly, the same	adverb	47
ὑποκριτής	hypocrite	noun	47
θησαυρός	treasure, treasury	noun	47
ἀνάγκη	necessity; pressure, distress	noun	47
ἐλέγχω	I expose, reprove, convict	verb	47
κἂν	and if, even if (καί + ἐάν)	conjunction	47
ῥίζα	root	noun	47
ἕτοιμος	prepared, ready	adjective	47
μέχρι	+gen., until, the point of	preposition	47
βρῶμα	food	noun	47
ἵππος	horse	noun	47
Καισάρεια	Caesarea	noun	47
ἄφεσις	pardon, forgiveness	noun	47
πλήρωμα	fullness	noun	47
χάρισμα	gift	noun	47
κρυπτός	secret, hidden	adjective	47
ἐξίστημι	I amaze, astound, astonish	verb	47
ὦ	O (exclamation)	interjection	47
περισσότερος	more, far more, greater	adjective	47
συλλαμβάνω	I seize, apprehend, arrest	verb	48
σφραγίς	seal	noun	48
κλέπτης	thief	noun	48
διαλογίζομαι	I consider, ponder, reason	verb	48
δεῖπνον	banquet, dinner, feast	noun	48
ἔπειτα	then	adverb	48
διατάσσω	I order, give orders, direct	verb	48
πλήρης	full	adjective	48
χορτάζω	I fill; I am satisfied	verb	48
δέσμιος	prisoner	noun	48
Ἔφεσος	Ephesus	noun	48
συκῆ	fig tree	noun	48
λύπη	grief, sorrow	noun	48
νυμφίος	bridegroom	noun	48
οὐδέποτε	never	adverb	48
τροφή	food, provisions	noun	48
ἐργάτης	worker	noun	48
τέρας	wonder, marvel	noun	48
γάμος	wedding celebration, wedding	noun	48
ζῆλος	jealousy, zeal, ardor	noun	48
πάθημα	suffering	noun	48
κακῶς	badly, severely, wrongly	adverb	48
ἐκτείνω	I stretch out, extend	verb	48
Καφαρναούμ	Capernaum	noun	48
ταχέως	quickly, soon, shortly	adverb	48
χόρτος	grass, hay	noun	49
Ἰορδάνης	Jordan	noun	49
τράπεζα	table	noun	49
Δαμασκός	Damascus	noun	49
κτίζω	I create	verb	49
ἐλαία	olive tree, olive	noun	49
ὑπακοή	obedience	noun	49
Λάζαρος	Lazarus	noun	49
νήπιος	infant, child	noun	49
εὐσέβεια	piety, godliness	noun	49
κληρονόμος	heir	noun	49
ὁμοιόω	I compare, make like	verb	49
οἰκουμένη	inhabited earth, world	noun	49
κρείττων	better	adjective	49
Σαῦλος	Saul	noun	49
εὐχαριστία	thanksgiving, thankfulness	noun	49
καταλαμβάνω	I grasp, lay hold of	verb	49
εἶτα	then	adverb	49
γεύομαι	I taste, experience, partake of	verb	49
τύπος	example, type, pattern	noun	49
ἀπάγω	I lead away, lead off	verb	49
παρθένος	virgin	noun	49
ἆρα	then, as a result	conjunction	49
ξηραίνω	I dry up, wither	verb	49
συμφέρω	I am profitable	verb	49
ῥαββί	rabbi, teacher	noun	50
μοιχεύω	I commit adultery	verb	50
γνωστός	known	adjective	50
ὄψιος	evening	adjective	50
λῃστής	robber, highwayman, bandit	noun	50
ἀνέχομαι	I endure, bear with	verb	50
ἐντέλλω	I command, order	verb	50
κληρονομία	inheritance	noun	50
μέτρον	measure	noun	50
κλάω	I break	verb	50
ἐνιαυτός	year	noun	50
μακρόθεν	from far away	adverb	50
ταπεινόω	I humble, make humble	verb	50
ἀφίστημι	I depart from, depart, go away	verb	50
φρόνιμος	prudent, wise	adjective	50
φύσις	nature, species	noun	50
μερίζω	I divide, deal out, apportion	verb	50
πετεινόν	bird	noun	50
διαλογισμός	reasoning, thought	noun	50
προσδέχομαι	I look forward to, wait for	verb	50
τάλαντον	talent	noun	50
μύρον	ointment, perfume	noun	50
ἀμφότεροι	both	adjective	50
ἀτενίζω	I look intently at, stare at	verb	50
νοέω	I understand	verb	50
Ἕλλην	Greek	noun	51
πωλέω	I sell	verb	51
ἐφίστημι	I stand at, stand near	verb	51
σκηνή	tent, tabernacle	noun	51
ἡγεμών	ruler, governer	noun	51
γεωργός	farmer, tenant farmer	noun	51
μεριμνάω	I am anxious; I care for	verb	51
ἐπιλαμβάνομαι	I take hold of, grasp	verb	51
κόπος	work, labor; toil, trouble	noun	51
ποταμός	river	noun	51
καταλύω	I destroy, throw down, demolish	verb	51
κερδαίνω	I gain	verb	51
ἐμβαίνω	I embark; I get into	verb	51
δηνάριον	denarius	noun	51
εὐλογία	blessing; praise; generous gift	noun	51
πέτρα	rock	noun	51
διαμαρτύρομαι	I warn, testify solemnly	verb	51
γυμνός	naked, poorly clothed	adjective	51
ξένος	stranger, foreigner	noun	51
κωφός	mute, unable to speak; deaf	adjective	51
λύχνος	lamp	noun	51
ἐπίσταμαι	I know, understand	verb	51
Σαδδουκαῖος	Sadducee	noun	51
αὔριον	tomorrow, next day	adverb	51
σεισμός	earthquake	noun	51
κοινόω	I defile	verb	52
κοινός	common, ordinary; unclean	adjective	52
μακροθυμία	patience, forbearance	noun	52
σῖτος	wheat, grain	noun	52
ἅπαξ	once, once and for all	adverb	52
γράμμα	letter	noun	52
οἷος	of what sort, such as	adjective	52
ἄκανθα	thorn plant, thorn	noun	52
ἀναχωρέω	I withdraw, go away	verb	52
καπνός	smoke	noun	52
πρίν	before	conjunction	52
παράδοσις	tradition	noun	52
καταισχύνω	I put to shame, humiliate	verb	52
ἐξαποστέλλω	I send off, send out, send away	verb	52
παιδίσκη	female slave	noun	52
ταχύς	quickly	adverb	52
ἄνωθεν	from above, top, again	adverb	52
Τίτος	Titus	noun	52
Ναζωραῖος	Nazarene	noun	52
δράκων	dragon	noun	52
ὕψιστος	highest; most high	adjective	52
θερισμός	harvest	noun	52
Μάρθα	Martha	noun	52
ἔξωθεν	outside	adverb	52
ζύμη	leaven	noun	52
ἀνάγω	I put out to sea, set sail	verb	53
λατρεύω	I serve, worship	verb	53
βασιλεύω	I rule, reign, be king	verb	53
ὑψόω	I lift up, exalt	verb	53
νηστεύω	I fast	verb	53
τοσοῦτος	so great, so much, so many	adjective	53
κατακρίνω	I pronounce sentence on	verb	53
καταγγέλλω	I proclaim	verb	53
εἰσπορεύομαι	I enter, go into	verb	53
τίκτω	I give birth (to)	verb	53
ῥύομαι	I rescue, deliver	verb	53
ἀρέσκω	I please	verb	53
τολμάω	I dare, show boldness	verb	53
ἀθετέω	I reject, declare invalid	verb	53
κατέρχομαι	I come down, arrive	verb	53
ἐπιθυμέω	I desire, long for, lust for	verb	53
ἀνακρίνω	I examine, judge, question	verb	53
προσδοκάω	I wait for, look for, expect	verb	53
ὠφελέω	I benefit, aid, profit	verb	53
δέρω	I beat, strike	verb	53
θρίξ	hair	noun	53
κατεσθίω	I eat up, consume, devour	verb	53
ἐλάχιστος	least, insignificant, trivial	adjective	53
χωλός	lame, crippled	adjective	53
ἀλλότριος	belonging to another	adjective	53
προάγω	I go before, precede	verb	54
κοιμάω	I sleep, fall asleep	verb	54
περιτέμνω	I circumcise	verb	54
ὑπομένω	I endure	verb	54
κατέχω	I hold fast to, restrain	verb	54
συνίστημι	I commend, recommend	verb	54
παρέχω	I cause, make happen, present	verb	54
ὑστερέω	I lack, fall short of	verb	54
ὄφις	snake, serpent	verb	54
ἕκτος	sixth	adjective	54
ἀνθίστημι	I oppose, resist	verb	54
ἀπειθέω	I disobey; I am disobedient	verb	54
ἀνάκειμαι	I recline, recline at table	verb	54
κατανοέω	I consider, contemplate	part	54
ἐμπαίζω	I ridicule, mock, make fun of	verb	54
συνεργός	fellow worker	noun	54
τρόπος	manner, way	noun	54
καθάπερ	just as, as	conjunction	54
ἀνά	each, apiece, in the midst	preposition	54
Ἀνδρέας	Andrew	noun	54
ἕξ	six	adjective	54
δαιμονίζομαι	I am possessed by a demon	verb	54
Φῆστος	Festus	noun	54
ἐπιζητέω	I seek after, wish for	verb	54
παιδεύω	I discipline, educate, train	verb	54
